{
  "name": "Splice",
  "structure": [
    ".....^....",
    "     M    ",
    "<2...4<<..",
    " i        ",
    ".2<<2.....",
    " d1dI     ",
    "....^.....",
    "    d     ",
    "....1>>>3.",
    "        i ",
    "....^.....",
    "          ",
    ">>>.......",
    "c d       ",
    "..v.^.....",
    "          ",
    "..4>S<<<2.",
    "  i     i ",
    "........^.",
    "          ",
    ".1>>>>>>..",
    "          ",
    ".^........",
    "          ",
    ".^...v3...",
    "     dI   ",
    ".^........",
    " b        "
  ],
  "input": {
    "items": [10,10, 0, 0, 0, 0, 0, 0, 0, 0, 0, 0 ]
  },
  "goals": {
    "items": [ 0, 0, 5, 0, 0, 0, 0, 0, 0, 0, 0, 0 ]
  }
}