{
  "name": "Victory!",
  "structure": [
    "..........",
    "          ",
    "..........",
    "          ",
    "..........",
    "          ",
    "..1>>>>2..",
    "          ",
    "..^....v..",
    "          ",
    ">>^....v<<",
    "c        b",
    "..^....v..",
    "          ",
    "..4<<<<3..",
    "          ",
    "...^..^...",
    "          ",
    "...^..^...",
    "          ",
    "...^..^...",
    "          ",
    "...^..^...",
    "          ",
    "...^..^...",
    "          ",
    "...^..^...",
    "   b  c   "
  ],
  "input": {
    "items": [10,10,0, 0, 0, 0, 0, 0, 0 ]
  },
  "goals": {
    "items": [ 0, 0, 0, 0, 0, 0, 0, 0,999 ]
  }
}