{
  "name": "Minions",
  "structure": [
    ".v........",
    " m        ",
    ".4>>>>>>2.",
    " i        ",
    "........v.",
    " i        ",
    ".1<<<<<<3.",
    " i        ",
    ".v........",
    "          ",
    ".4>>>>>>2.",
    " i   4    ",
    "........v.",
    "          ",
    "..1<<2..v.",
    "  i  i    ",
    ">>>>>S<<3.",
    "  d        ",
    "..v.......",
    "          ",
    "..v.......",
    "  1       ",
    "..........",
    "          ",
    "..........",
    "          ",
    "..........",
    "          "
  ],
  "input": {
    "items": [ 0, 0,99, 0, 0, 0, 0, 0, 0 ]
  },
  "goals": {
    "items": [ 0, 0, 0, 0, 0, 0, 0, 0,10 ]
  }
}