{
  "height": 14,
  "width": 10,
  "structure": [
    ".......X..",
    "          ",
    ".......^..",
    "          ",
    ".......^..",
    "          ",
    ".......^..",
    "          ",
    ".......^..",
    "          ",
    ">>>>>2.^..",
    "          ",
    ".....v.^..",
    "          ",
    "..1>>v>3..",
    "     d i  ",
    "..^..v....",
    "          ",
    "..^..4>>>X",
    "     i    ",
    "..^.......",
    "          ",
    "..^.......",
    "          ",
    "..^.......",
    "          ",
    "..^.......",
    "  b       "
  ],
  "goals": {
    "items": [ 0, 5, 0 ]
  }
}