{
  "name": "Minions",
  "structure": [
    ".v........",
    " m        ",
    ".4>>>>>>2.",
    " i 4      ",
    "........v.",
    " i        ",
    ".1<<<<<<3.",
    " i        ",
    ".v........",
    "          ",
    ".4>>>>>>2.",
    " i   4    ",
    "........v.",
    "          ",
    "..1<<2..v.",
    "  i  i    ",
    ">>>>>S<<3.",
    "g d       ",
    "..v.......",
    "          ",
    "..v.......",
    "  1       ",
    "..v.v.v.v.",
    "          ",
    "..v.v.v.v.",
    "          ",
    "..v.v.v.v.",
    "  X X X X "
  ],
  "input": {
    "items": [ 0, 0,99, 0,99, 0, 0, 0, 0 ]
  },
  "goals": {
    "items": [ 0, 0, 0, 0, 0, 0, 0, 0,10 ]
  }
}