{
  "height": 14,
  "width": 10,
  "structure": [
    ".......X..",
    "          ",
    ".......^..",
    "          ",
    "..5<6..^..",
    "          ",
    "..v.^..^..",
    "          ",
    "..8>7..^..",
    "          ",
    ">>>>>>>S<<",
    "c        b",
    ".1>>>>>2..",
    "          ",
    ".^.....v..",
    "          ",
    ".^.....v..",
    "          ",
    ".^.....v..",
    "          ",
    ".4<<<<<3..",
    "   ddd    ",
    "..........",
    "          ",
    "..........",
    "          ",
    "..........",
    "          "
  ],
  "goals": {
    "items": [ 0, 0, 3 ]
  }
}