{
  "name": "Only Chicks Matter",
  "structure": [
    "..........",
    "          ",
    "..........",
    "          ",
    "..........",
    "          ",
    "X<<<<<<<<<",
    "   dddd  b",
    "..........",
    "          ",
    "..........",
    "          ",
    "..........",
    "          ",
    "..1>>..>>X",
    "  2       ",
    "..^.......",
    "  2       ",
    "..^.......",
    "  2       ",
    "..4.<<<2..",
    "       i  ",
    ".......^..",
    "          ",
    ".......^..",
    "          ",
    ".......^..",
    "       c  "
  ],
  "input": {
    "items": [999,10, 0, 0, 0, 0, 0, 0, 0 ]
  },
  "goals": {
    "items": [ 0, 5, 0, 0, 0, 0, 0, 0, 0 ]
  }
}