{
  "height": 14,
  "width": 10,
  "structure": [
    "..........",
    "          ",
    "..........",
    "          ",
    ">>>>>>>>>>",
    "c         ",
    "..........",
    "          ",
    "<<<<<<<<<<",
    "         b",
    "..........",
    "          ",
    "..........",
    "          ",
    "..........",
    "          ",
    "..........",
    "          ",
    "..........",
    "          ",
    "..........",
    "          ",
    "..........",
    "          ",
    "..........",
    "          ",
    "..........",
    "          "
  ],
  "goals": {
    "items": [ 0, 0, 9999 ]
  }
}