{
  "name": "Sum Of Parts",
  "structure": [
    ".....^....",
    "     G    ",
    ".....^....",
    "          ",
    "........>.",
    "        d ",
    "..........",
    "          ",
    "..v..^....",
    "  d       ",
    ".....^....",
    "     1    ",
    "<<2..4<1<<",
    "Y i   di c",
    "..^..^....",
    "          ",
    "...<<^<...",
    "     3    ",
    "..........",
    "          ",
    ".......3..",
    "       d  ",
    "....4.....",
    "    d     ",
    "..........",
    "          ",
    "..........",
    "          "
  ],
  "input": {
    "items": [ 0, 10, 0, 0, 0, 0, 0, 0, 0, 0, 0, 0 ]
  },
  "goals": {
    "items": [ 0, 0, 0, 0, 5, 5, 0, 0, 0, 0, 0, 0 ]
  }
}