{
  "name": "Untitled",
  "structure": [
    ".....X....",
    "          ",
    ".....4<<2.",
    "        i ",
    "........^.",
    "          ",
    "........^.",
    "          ",
    "....1>>>3.",
    "        i ",
    "....^.....",
    "          ",
    ">>2.^.....",
    "c         ",
    "..v.^.....",
    "          ",
    "..4>S<<<2.",
    "  i     i ",
    "........^.",
    "          ",
    ".1>>>>>>3.",
    "        i ",
    ".^........",
    "          ",
    ".^........",
    "          ",
    ".^........",
    " b        "
  ],
  "input": {
    "items": [10,10, 0, 0, 0, 0 ]
  },
  "goals": {
    "items": [ 0, 0, 5, 0, 0, 0 ]
  }
}