{
  "name": "Parts We Want",
  "structure": [
    ".....X....",
    "          ",
    ".....^....",
    "          ",
    ".....^....",
    "          ",
    ".....^....",
    "     1    ",
    ".....^....",
    "          ",
    ".....^....",
    "          ",
    "<<2..4<1<<",
    "  i   di c",
    "..^..^....",
    "          ",
    "...<<^<...",
    "     3    ",
    "..........",
    "          ",
    ".......3..",
    "       d  ",
    "....4.....",
    "    d     ",
    "..........",
    "          ",
    "..........",
    "          "
  ],
  "input": {
    "items": [ 0,10, 0, 0, 0 ]
  },
  "goals": {
    "items": [ 0, 0, 0, 0, 5 ]
  }
}